=LiveCart Help

	intro=Introduction

	installation=Installation

	cat=Product Categories
		details=Category Details
		attr=Attributes
		filters=Filters
		images=Images
		
	products=Products
		add=Add New Product
		
	order=Orders		
		
	user=Users		
		
	currency=Currencies
		
	language=Languages
		edit=Edit Translations
		
	cust=Customization
		template=Templates
		css=CSS
		skin=Skins
		
	dev=Developers Manual
		app=Application
			model=Models
			view=Views
				helper=Helpers
			controller=Controllers
			directory=Directories
			diagram=Diagrams
				uml=UML Diagrams
				db=Database Diagram
			codedoc=Code Documentation
		plugin=Plugins
			payment=Payment Processors
			shipping=Real-time Shipping
			currency=Currency Rate Update
		api=APIs
			soap=SOAP API
			php=PHP API